SO textures/wolfenstein/wallhole.xpm
NO textures/wolfenstein/new_stone.xpm
EA textures/wolfenstein/wood_wall.xpm
WE  textures/wolfenstein/wood.xpm

F 212,135,209
C 82,187,232

111111111111111111111
100000100000100000001
101111101111101111101
100000100000100000001
101110111111101111101
100010000000100000001
101110111111101111101
100000100000100000001
101111101111101111101
1000001000001000000N1
111111111111111111111


