SO textures/wolfenstein/wood.xpm
NO textures/wolfenstein/wood_wall.xpm
EA textures/wolfenstein/wall3.xpm
WE textures/wolfenstein/wall2.xpm

F 120,80,40
C 60,40,20

111111111111111111111
100000000000000000001
101111111011111111101
100000001010000000001
101111101110111111101
100000100000100000001
101111101111101111101
100000100000100000001
101111111111111111101
10000000000000000N001
111111111111111111111
