SO textures/wolfenstein/wood.xpm
NO textures/wolfenstein/wood_wall.xpm
EA textures/wolfenstein/wall3.xpm
WE textures/wolfenstein/wall2.xpm

F 120,80,40
C 60,40,20


111111111111111111111
100000100000100000001
101111101111101111101
100010100010100010001
101111101111101111101
100000100N00100000001
101111111111111111101
100000100000100000001
101111101111101111101
100000100000100000001
111111111111111111111
