SO textures/wolfenstein/wallhole.xpm
NO textures/wolfenstein/new_stone.xpm
EA textures/wolfenstein/wood.xpm
WE textures/wolfenstein/wall3.xpm

F 212,135,209
C 82,187,232

    111111111111111111111
    100000111000111000001
    101110101110101110101
    11010100000100011111
11111 101111101110101
100001101000101000001
101111101110101111101
1N0000100000100000001
101111101111101111101
100000100000100000001
111111111111111111111
